100000000000000000000000000000000000000000000000000000000000000000000000000000000000000000000000000000000000000000000000000000
100000000000000000000000000000000000000000000000000000000000000000000000000000000000000000000000000000000000000000000000000000
100000000000000000000000000000000000000000000000000000000000000000000000000000000000000000000000000000000000000000000000000000
100000000000000000000000000000000000000000000000000000000000000000000000000000000000000000000000000000000000000000000000000000
100000000000000000000000000000000000000000000000000000000000000000000000000000000000000000000000000000000000000000000000000000
100000000000000000000000000000000000000000000000000000000000000000000000000000000000000000000000000000000000000000000000000000
100000000000000000000000000000000000000000000000000000000000000000000000000000000000000000000000000000000000000000000000000000
100000000000000000000000000000000000000000000000000000000000000000000000000000000000000000000000000000000000000000000000000000
100000000000000000300000000000000000000000000000000000000000000000000000000000000000000000000000000000000000000000000000000000
100000000000000000000000000000000000000000000000000000000000000000000000000000000000000000000000000000000000000000000000000000
100000000000000000000000000000000000000000033300000000000000000000000000000000000000000000000000000000000000010000000000000000
100000000000000000000000000000000030330000000000000000000000000000000000000000000000000000000000000000000000110000000000000000
111000000003000023232000000000000300000000011000300000000000000000000000000000000000000000000000000000000001110000000000000000
100000000000000000000000000000003000110000111100300000000000000000000000000000000000000000011000000000000011110000000000000000
100000000000000000000000000000003001111000111100300000003330000000000000000000000000001100000000000000000111110000000000000000
100000400000000100400000000000000001111000111100000000000000000000000000000000000000000000000000000000001111110000000000005000
111111111111111111111111111111111111111111111111111111111111111111110000111111111111100000000001111111111111111111111111111111
111111111111111111111111111111111111111111111111111111111111111111110000111111111111100000000001111111111111111111111111111111