100000000000000000000000000000000000000000000000000000000000000000000000000000000000000000000000000000000000000000000000000000000000000000000000000000000000000000000000000000000000000000000000000000000000000000000000000
100000000000000000000000000000000000000000000000000000000000000000000000000000000000000000000000000000000000000000000000000000000000000000000000000000000000000000000000000000000000000000000000000000000000000000000000000
100000000000000000000000000000000000000000000000000000000000000000000000000000000000000000000000000000000000000000000000000000000000000000000000000000000000000000000000000000000000000000000000000000000000000000000000000
100000000000000000000000000000000000000000000000000000000000000000000000000000000000000000000000000000000000000000000000000000000000000000000000000000000000000000000000000000000000000000000000000000000000000000000000000
100000000000000000000000000000000000000000000000000000000000000000000000000000000000000000000000000000000000000000000000000000000000000000000000000000000000000000000000000000000000000000000000000000000000000000000000000
100000000000000000000000000000000000000000000000000000000000000000000000000000000000000000000000000000000000000000000000000000000000000000000000000000000000000000000000000000000000000000000000000000000000000000000000000
100000000000000000000000000000000000000000000000000000000000000000000000000000000000000000000000000000000000000000000000000000000000000000000000000000000000000000000000000000000000000000000000000000000000000000000000000
100000000000000000000000000000000000000000000000000000000000000000000000000000000000000000000000000000000000000000000000000000000000000000000000000000000000000000000000000000000000000000000000000000000000000000300000000
100000000000000000300000000000000000000000000000000000000000000000000000000000000000000000000000000000000000000000000000000000000000000000000000000000000000000000000000000000000000000000000000000000000000000003030000000
100000000000000000000000000000000000000000000000000000000000000000000000000000000000000000000000000000000000000000000000000000000000000000000000000000000000000000000000000000000000000000000000000000000000000000000000000
100000000000000000000000000000000000000000033300000000000000000000000000000000000000000000000000000000000000000000000000000000000000000000000000003300000000000000000000000000000000000000000000000000000000000001000000000
100000000000000000000000000000000030330000000000000000000000000000000000000000000000000000000000000000000000000000000000000000000000000000000000003300300000000000000000000000000000000000000000000000000000000011000000000
111000000003000023232000000000000300000000011000300000000000000000000000000000000000000000000000000000000000000000000000000000000000000000000000000000300000000000000000000000000000000000000000000000000000000111000000000
100000000000000000000000000000003000110000111100300000000000000000000000000000000000000000011000000000000000000000000000000000000000000000003000001100300000000000000000000000000000000000000000300000000000001111000000000
100000000000000000000000000000003001111000111100300000003330000000000000000000000000001100000000000003330000000000000000000000000000333000030300000000000033000000000000000000333300000000000000300000000000011111000000000
100000400000000100400000000000000001111000111100000000000000400000000000000000000000000000000000000000400000000000000000000000000000040000000001000000100000000010000400000001000010000040000000100000400000111111000050000
111111111111111111111111111111111111111111111111111111111111111111110000111111111111100000000001111111111111111000300003003003011111111111100000000000000011000011111111111111000011111111111111111111111111111111111111111
111111111111111111111111111111111111111111111111111111111111111111110000111111111111100000000001111111111111111001110011001001011111111111100000000000000000000011111111111111000011111111111111111111111111111111111111111